G                        G
G                        G
G                        G
G                        G
G                        G
G                        G
G  GEEEM          MEEEG  G
G                        G
GG     M    F     M     GG
G                        G
G  G        P         G  G
G                        G
GG          G           GG
GGGGGGG    GGG     GGGGGGG
G        MGGGGGM         G
G        GGGGGGG         G
G       GGGGGGGGG        G
GM J M GGGGGGGGGGG M J M G
GGGGGGGGGGGGGGGGGGGGGGGGGGG